1111111111111
1000000000001
1000023232321
1000000000001
1000023232321
1000000020001
1032023232301
1000000000001
1032320232321
1000000002001
1032320232321
1000000000001
1111111111111